{
    "1": "类型1",
    "2": "类型2",
    "3": "类型3",
    "4": "类型4",
    "5": "类型5",
    "6": "类型6",
    "7": "类型7",
    "8": "类型8",
    "9": "类型9",
    "10": "类型10",
    "11": "类型11",
    "99": "首页公告"
}